NO ./nfour.png
SO ./N_minecraft.png
WE ./oui.png
EA ./bricksx64_EST.png

C 128,191,255
F 77,72,58

            1111111111111
            1000000000001
            1000000000001
            1000000000001
            1000000000001
            100000S000001
1111111111111000000000001
1000000000110000000010001
1011000001110000000000001
1001000000000000000010001111111111111
1000000000000011000000000000000000001
1000000000110000011100000000111111111
11110000000000011100000010001
11110000000000011101010010001
11000000110101011100000010001
10000000000000001100000010001
10000000000000001101010010001
11111111111111111111111111111
