NO ./path_to_the_north_texture
SO ./path_to_the_south_texture
WE ./path_to_the_west_texture
EA ./path_to_the_east_texture


C 0,255,0
F 0,0,250



            1111111111111
            1W00000000001
            1000000000001
            1000000000001
            1000000000001
            1000000000001
1111111111111000000000001
1000000000110000000000001
1011000001110000000000001
1001000000000000000000001111111111111
1000000000000011000000000000000000001
1000000000110000011101111111111111111
11110000000000011100000010001
11110000000000011101010010001
11000000110101011100000010001
10000000000000001100000010001
10000000000000001101010010001
11111111111111111111111111111
