NO ./bricksx64_NORTH.png
SO ./bricksx64_SOUTH.png
WE ./bricksx64_OUEST.png
EA ./bricksx64_EST.png

C 80,90,120
F 20,200,30

1111111111111111111111111111111111111111111111111111111111111111111111111
1000000010000000000011000000000001100000000000110000000000011000000000001
100N000100000000000110000000000011000000000001100000000000110000000000011
1000000010000000000011000000000001100000000000110000000000011000000000001
1000000020000000000011000000000001100000000000110000000000011000000000001
1000000010000000000011000000000001100000000000110000000000011000000000001
1000000010000000000011000000000001100000000000110000000000011000000000001
1112112111111111111111111111111111111111111111111111111111111111111111111
